1, 1, 2, 2, 2, 2, 2, 2, 3, 3
1, 2, 2, 1, 4, 4, 4, 4, 4, 3
1, 1, 1, 1, 4, 5, 3, 3, 3, 3
4, 4, 4, 4, 4, 5, 5, 6, 6, 6
4, 7, 7, 7, 7, 7, 5, 8, 8, 6
7, 7, 9, 9, 9, 9, 5, 8, 6, 6
7, 9, 9, 0, 0, 9, 5, 8, 8, 8
7, 9, 7, 7, 0, 9, 5, 5, 0, 8
7, 9, 9, 7, 0, 9, 0, 0, 0, 8
7, 7, 7, 7, 0, 0, 0, 8, 8, 8 
